*********E***********
*         *   *   * *
* ******* * * * * * *
* * S * * * * * * * *
* * * * *** * * * * *
* * * *   * * * * * *
* * * * * * * * * * *
* * * * * * * * * * *
* * * * * * * * * * *
* * * * * * * * * * *
*   *   *   *   *   *
*********************
